"filename", "language", "cpp", "comment", "blank", "total"
"/root/workspace/MyReactor/final/Acceptor.cpp", "cpp", 29, 0, 8, 37
"/root/workspace/MyReactor/final/Buffer.cpp", "cpp", 77, 0, 16, 93
"/root/workspace/MyReactor/final/Channel.cpp", "cpp", 106, 0, 22, 128
"/root/workspace/MyReactor/final/Connection.cpp", "cpp", 135, 0, 22, 157
"/root/workspace/MyReactor/final/EchoServer.cpp", "cpp", 87, 0, 21, 108
"/root/workspace/MyReactor/final/Epoll.cpp", "cpp", 76, 0, 12, 88
"/root/workspace/MyReactor/final/EventLoop.cpp", "cpp", 143, 0, 24, 167
"/root/workspace/MyReactor/final/InetAddress.cpp", "cpp", 32, 0, 11, 43
"/root/workspace/MyReactor/final/Socket.cpp", "cpp", 82, 0, 18, 100
"/root/workspace/MyReactor/final/TcpServer.cpp", "cpp", 134, 0, 31, 165
"/root/workspace/MyReactor/final/ThreadPool.cpp", "cpp", 115, 0, 32, 147
"/root/workspace/MyReactor/final/Timestamp.cpp", "cpp", 45, 0, 11, 56
"/root/workspace/MyReactor/final/bankclient.cpp", "cpp", 61, 0, 18, 79
"/root/workspace/MyReactor/final/bankserver.cpp", "cpp", 34, 0, 8, 42
"/root/workspace/MyReactor/final/client.cpp", "cpp", 61, 0, 18, 79
"/root/workspace/MyReactor/final/client1.cpp", "cpp", 94, 0, 18, 112
"/root/workspace/MyReactor/final/tcpepoll.cpp", "cpp", 141, 0, 19, 160
"/root/workspace/netserver/38/Acceptor.cpp", "cpp", -29, 0, -8, -37
"/root/workspace/netserver/38/Buffer.cpp", "cpp", -77, 0, -16, -93
"/root/workspace/netserver/38/Channel.cpp", "cpp", -106, 0, -22, -128
"/root/workspace/netserver/38/Connection.cpp", "cpp", -135, 0, -22, -157
"/root/workspace/netserver/38/EchoServer.cpp", "cpp", -87, 0, -21, -108
"/root/workspace/netserver/38/Epoll.cpp", "cpp", -76, 0, -12, -88
"/root/workspace/netserver/38/EventLoop.cpp", "cpp", -143, 0, -24, -167
"/root/workspace/netserver/38/InetAddress.cpp", "cpp", -32, 0, -11, -43
"/root/workspace/netserver/38/Socket.cpp", "cpp", -82, 0, -18, -100
"/root/workspace/netserver/38/TcpServer.cpp", "cpp", -134, 0, -31, -165
"/root/workspace/netserver/38/ThreadPool.cpp", "cpp", -115, 0, -32, -147
"/root/workspace/netserver/38/Timestamp.cpp", "cpp", -45, 0, -11, -56
"/root/workspace/netserver/38/bankclient.cpp", "cpp", -61, 0, -18, -79
"/root/workspace/netserver/38/bankserver.cpp", "cpp", -34, 0, -8, -42
"/root/workspace/netserver/38/client.cpp", "cpp", -61, 0, -18, -79
"/root/workspace/netserver/38/client1.cpp", "cpp", -94, 0, -18, -112
"/root/workspace/netserver/38/tcpepoll.cpp", "cpp", -141, 0, -19, -160
"Total", "-", 0, 0, 0, 0